Çünkü-Çünkü : ben-ben : de-de : o-o : yaşadığı-yaş : çevreyi-çevre : kirleterek-kirlet
bozulmasına-boz : neden-neden : olan-ol : tüm-tüm : uyarılara-uyarı : kulağını-kulağ
tıkayan-tıkaya : soya-soy : aitim-ait : Kimileri-Kimi : buna-bu : kader-kader
diyordu-di : kimileri-kimi : unut-unut : Bu-Bu : da-da : zaman-zaman
ister-iste : emek-emek : ister-iste : İki-İki : veli-ve : dokunulsa-dokunuls
ağlayacaktı-ağla : Bu-Bu : meslek-meslek : böyle-böyle : dir-di : Filmde-Fil
kamburunu-kambur : çıkarmış-çık : eski-eski : Yugoslav-Yugoslav : lideri-lider : iki-iki
kişinin-kişi : arasında-ara : elleri-el : önden-ön : bağlı-bağ : cezaevi-cezaev
avlusunda-avlu : yürüyor-yürü : Sabahları-Sabah : hiçbir-hiçbir : şey-şey : yemeden-ye
içmeden-iç : paldür-pal : küldür-kül : çıkıyorum-çık : evden-ev : Bu-Bu
albüm-albüm : hit-hi : şarkı-şarkı : çıkarmaz-çıkar : dedim-de : Bu-Bu
tesisin-tesis : SASA'nın-SASA'nı : büyümesinde-büyü : büyük-büyük : katkısı-katkı : oldu-ol
Çağırdım-Çağırdı : Genelkurmay-Genelkurmay : Başkanı'nı-Başkan : Ama-Ama : önce-önce : uyumadan-uyu
önce-önce : notlarıma-not : bir-bir : çeki-çeki : düzen-düzen : vermem-ver
gerek-gerek : Saçlarını-Saç : yıkamış-yıka : Hayır-Hayır : ben-ben : masal-masal
istiyorum-isti : Helikopterler-Helikopterle : ve-ve : uçaklar-uçak : da-da : gökyüzünde-gökyüz
uçarlar-uç : Postmodernleşen-Postmodernleşe : dünyayla-dünya : birlikte-birlikte : edebiyatın-edebiyat : algılanışı-algıla
da-da : dönüştü-dönüş : giderek-gid : bir-bir : eğlence-eğlence : nesnesi-nesne
hoşça-hoş : vakit-vakit : geçirme-geçir : aracı-ara : olarak-ol : değerlendiriliyor-değer
Sonradan-Sonra : bir-bir : inceldi-incel : bir-bir : inceldi-incel : Baba-Baba
deriz-de : baba-baba : ölüm-ölüm : ne-ne : dir-di : Cevap-Cevap
şöyle-şöyle : ydi-yd : Bu-Bu : soruya-soru : Veysel'in-Veysel : Tabi-Tabi
olur-ol : diyerek-di : uzun-uzun : uzun-uzun : anlatmaya-anla : girişeceğini-giriş
zannediyordum-zanned : İstanbulspor-İstanbulspo : Vanspor-Vanspo : Karşıyaka-Karşıyaka : Göztepe-Göztep : gibi-gibi
bazı-bazı : kulüpler-kulüp : dernek-dernek : yapısı-yapı : dışında-dış : futbol-futbol
şubelerini-şube : kurulan-kur : veya-veya : kurulmuş-kur : bulunan-bulun : anonim-anoni
şirketlere-şirket : devrediyor-devred : Birtakım-Birtakım : gerilimler-gerilim : yaşadık-yaşa : Hatta-Hatta
Türkiye'ye-Türkiye : 1986-1986 : yılında-yıl : geri-geri : döndükten-dön : sonra-sonra
bile-bile : Meclis-Meclis : kararı-karar : gereği-gereğ : Doğu-Doğu : Akdeniz'in-Akdeniz
güvenliğini-güven : sağlamak-sağla : üzere-üzere : deniz-deniz : unsurunu-unsur : oluşturan-oluş
Gaziantep-Gaziantep : Firkateyni-Firkateyn : ve-ve : iki-iki : korvetle-korvetl : yaklaşık-yaklaşık
300-300 : denizci-denizci : bir-bir : hafta-hafta : içinde-iç : Doğu-Doğu
Akdeniz'e-Akdeniz : gidecek-gid : Geçim-Geç : kaygısı-kaygı : içinde-iç : olanlar-ol
Meclis'in-Meclis : güçlü-güç : olmasını-ol : istiyor-isti : Herkes-Herkes : öyle-öyle
ya-ya : da-da : böyle-böyle : içinde-iç : bir-bir : şekilde-şekil
bir-bir : şeylere-şey : dair-dair : mutlaka-mutlaka : bir-bir : umut-umut
taşır-taş : Duş-Duş : veya-veya : banyo-banyo : esnasında-esna : su-su
kullanarak-kullan : elle-elle : ya-ya : da-da : yine-yine : su-su
kullanarak-kullan : her-her : hangi-hangi : bir-bir : parfümsüz-parfüm : beyaz-beyaz
sabunla-sabunl : yapılacak-yap : olan-ol : temizlik-temiz : vajinanın-vajina : ön-ön
bölgesinden-bölge : klitoris-klitoris : başlangıcından-başlangıc : anüse-anüs : dışkılık-dışkılı : doğru-doğru
olmalıdır-ol : Oluşan-Oluş : kabarcıklar-kabar : patlatılmaz-patlatılma : Ben-Ben : kendi-kendi
hesabıma-hesab : bir-bir : denizin-de : kenarında-kenar : elimde-el : bir-bir
rakı-rakı : bardağı-bardağ : ve-ve : yanımda-yan : Isabelle-Isabell : Adjani-Adjan
ile-ile : oturduğumda-otur : mutlu-mutlu : oluyorum-ol : Parasız-Para : pulsuzduk-pulsuzdu
Behlül-Behlül : Dayım'ın-Dayım'ı : teyzemin-teyze : ellerine-el : bakıyorduk-bak : Kimileri-Kimi
hemen-hemen : çizmeye-çiz : başladı-başla : Ahmet-Ahmet : Hamdi-Hamdi : Tanpınar-Tanpına
Beş-Beş : Şehir-Şehir : adlı-adlı : başyapıtında-başyapıtınd : Konya'yı-Konya : dile-dile
getirirken-getir : 699-699 : yılının-yı : o-o : müthiş-müthiş : günlerinden-gün
de-de : söz-söz : açar-açar : Uhuru'dan-Uhuru'da : önce-önce : şu-şu
otelden-otel : içeri-içeri : zor-zor : girebilir-gir : dik-dik : Nazik-Nazi
ve-ve : sıcak-sıcak : bir-bir : özür-özür : gülümseyişiyle-gülümseyişiyl : Umutlu-Umut
ydum-ydu : Kızı-Kız : al-al : eve-ev : götür-götür : dinlensin-dinlen
Çocuğun-Çocuğ : ödü-öd : patladı-patla : Şair-Şair : sizin-siz : yaşadığınız-yaşa
ilden-il : de-de : söz-söz : edecek-ed : olsaydı-ol : sizce-siz
hangi-hangi : özelliğini-özel : söylerdi-söyle : Ben-Ben : yol-yol : bilmem-bil
iz-iz : bilmem-bil : Ama-Ama : rahatsız-rahat : değilim-değil : Öğretmenlere-Öğretmen
mutlaka-mutlaka : teşekkür-teşekkür : edin-edin : İşin-İş : en-en : ilginç-ilginç
tarafı-tara : ise-is : öğretmenlerimizin-öğretmen : bize-biz : hemen-hemen : her-her
zaman-zaman : söyledikleri-söyle : bir-bir : şeyi-şey : kendilerinin-kendi : uygulamamasıydı-uygulamamasıyd
Bu-Bu : uygulamayı-uygula : kurallaştırmamıştır-kurallaştırmamıştı : Televizyonların-Televizyon : yaptığı-yap : tahminler-tahmin
"hayır-"hay : tarafının-taraf : çok-çok : az-az : farkla-fark : önde-ön
gittiğini-git : gösteriyor-göster : Bizi-Bi : korkuturlardı-korkut : şimdi-şimdi : kuyu-kuyu
anası-an : çıkacak-çık : diye-diye : Örgütün-Örgüt : gizli-gizli : araştırmasında-araştır
sirk-sir : görevlileriyle-görevlileriyl : birlikte-birlikte : çalışıldığı-çalış : ve-ve : kötü-kötü
muamelelerin-muamele : filme-fil : alındığı-alın : belirtildi-belir : Oluktan-Ol : düşenleri-düş
2-2 : Kitap-Kitap : okumak-oku : neden-neden : önemli-önem : dir-di
Aslan-Aslan : burcu-burcu : kadınları-kadı : yalandan-yal : dolandan-dol : nefret-nefret
ederler-ed : Değerlendirme-Değer : Soruları-Soru : Hayır-Hayır : demiş-de : çocuk-çocuk
Başka-Başka : bir-bir : tencerede-tencere : yağ-yağ : bir-bir : çorba-çorba
kaşığı-kaşığ : un-un : ile-ile : pembeleştirilir-pembe : Bebe-Beb : gibi-gibi
kollarımda-kol : yaylattım-yayla : Yeni-Yeni : kıtalara-kıta : açılmış-aç : kâşifler-kâşif
Böyle-Böyle : kadrolarla-kadro : ekonomide-ekonomi : eğitimde-eğit : her-her : alanda-al
bilimsel-bilimsel : rasyonel-rasyonel : politikalar-politika : üretilemediği-üretilemediğ : gibi-gibi : ele-ele
geçen-geçen : iç-iç : ve-ve : dış-dış : kaynaklar-kaynak : yardımlar-yardım
da-da : yeterince-yeterince : değerlendirilemiyor-değerlendirilemiyo : hatta-hatta : israf-israf : olunuyor-olunuyo
Bu-Bu : sorunun-sor : yanıtı-yanıt : kesin-kesin : olarak-ol : hayır-hayır
dır-dır : KAÇ-KAÇ : KİŞİLİK-KİŞİLİK : 4-4 : Öyle-Öyle : güzel-güzel
yetiştirmişsiniz-yetiştirmişsini : ki-ki : onu-on : Stadın-Stad : ışıkları-ışık : söndü-sön
Hem-Hem : tutuklu-tutuklu : olup-ol : hem-hem : bir-bir : şey-şey
yapamazsınız-yap : Toplumun-Toplu : bu-bu : kadar-kadar : açlık-açlık : işsizlik-iş
eşitsizlik-eşit : gibi-gibi : sorunu-sor : var-var : ken-ke : Cezayir'in-Cezayir
karnı-karnı : lafa-laf : tok-tok : Ağır-Ağır : ama-ama : emin-emin
adımlarla-adım : ilerleyin-ilerle : Daha-Daha : nasıl-nasıl : çanta-çanta : derdinde-derd
olmayayım-olmayayı : Öyle-Öyle : parçalar-parça : var-var : işte-işte : Ama-Ama
gözlerinin-göz : ıslandığını-ısla : gördüm-gör : Süzme-Süzm : yoğurt-yoğurt : çırpılmış-çırp
yumurta-yumurta : ve-ve : 2-2 : çorba-çorba : kaşığı-kaşığ : un-un
karışımını-karışım : azar-azar : azar-azar : ilave-ilave : ederek-ed : karıştırın-karış
Derken-De : Wonka-Wonk : çikolatalarına-çikolata : gizlenmiş-giz : 5-5 : altın-altın
bileti-bile : bulan-bulan : 5-5 : şanslı-şans : çocuğu-çocuğ : bütün-bütün
sırlarını-sır : ve-ve : büyüsünü-büyü : göstereceği-göster : fabrikasına-fabrika : davet-davet
edip-edip : gezdireceğini-gezdireceğin : ve-ve : içlerinden-iç : birine-bir : fabrikayı-fabrika
devredeceği-devred : sürprizini-sürpriz : ilan-ilan : edince-ed : bir-bir : bilet-bilet
avıdır-av : başlıyor-başlı : KELAYNAK-KELAYNAK : KUŞU-KUŞ : Ülkemi-Ülke : aydınlatan-aydınlat
medeniyet-medeniyet : hürriyet-hürriyet : Gerçek-Gerçek : bir-bir : koleksiyoncu-koleksiyonc : kazanç-kazanç
amacı-ama : gütmez-gütme : sırf-sırf : zevki-zevk : için-için : koleksiyon-koleksiyo
yapar-yap : Bu-Bu : eylem-eylem : kent-kent : insanının-insan : kültürel-kültürel
gelişiminin-gelişim : doruklarına-doruk : varmasının-var : bir-bir : göstergesi-gösterge : kabul-kabul
edilir-ed : Bizim-Biz : gündelik-gündelik : gerçekliğe-gerçek : bakışımızın-bakışımızı : içerdiği-içer
ideolojik-ideolojik : etik-etik : ve-ve : estetik-estetik : değerlerin-değer : toplamıdır-toplam
Psikolojik-Psikoloji : psikiyatrik-psikiyatri : organik-organ : ilaç-ilaç : kullanımı-kullan : gibi-gibi
nedenlerle-neden : ortaya-orta : çıkar-çıkar : Hücum-Hücu : etmesini-et : bilen-bi
kadar-kadar : bilmeyen-bil : de-de : vardı-var : bu-bu : ülkede-ülke
son-son : vuruşu-vur : yapan-yap : kadar-kadar : yapamayan-yap : da-da
orta-orta : sahada-saha : top-top : çeviren-çevir : de-de : çevirmeyen-çevir
de-de : Evimde-Ev : olmak-ol : istiyorum-isti : Doktor-Doktor : Alooo-Alooo
der-der : demez-de : ölü-ölü : Alo-Alo : buyrunuz-buyrunu : diye-diye
dikelmiş-dikelm : Şimdi-Şimdi : yaşadığım-yaşa : batının-bat : verimli-verim : bölgelerinden-bölge
doğduğum-doğ : yörelere-yöre : her-her : gidişimde-gidişimd : bizim-biz : kupkuru-kupkur
dağlarımıza-dağ : bozkırlarımıza-bozkırlarımız : yaklaştıkça-yaklaş : burnumun-burnu : direği-direğ : sızlıyor-sızlıyo
Şimdi-Şimdi : P"ye-P"y : basmanın-bas : tam-tam : zamanı-zam : işte-işte
Domates-Domates : ve-ve : domates-domates : salçası-salça : ilave-ilave : edip-edip
soteleyin-soteleyi : Babasının-Baba : el-el : yazısıyla-yazı : yazılmış-yaz : küçük-küçük
bir-bir : kitap-kitap : duruyormuş-duruyorm : içinde-iç : Türkiye-Türkiye : istikrar-istikrar
içinde-iç : güven-güven : içinde-iç : büyüyor-büyü : kalkınıyor-kalk : Bunu-Bu
getirmenin-getir : farklı-fark : faydaları-fayda : da-da : var-var : Doktrine-Doktrin
olan-ol : katkısı-katkı : dolayısıyla-dolayı : ismi-ismi : sistemle-sistem : birlikte-birlikte
anılmaya-an : getirilen-getir : kültüre-kültür : Marxizm-Marxiz : Leninizm-Leniniz : denilmeye-denilmey
başlandı-baş : Türkiye'ye-Türkiye : de-de : Henry-Henry : gibi-gibi : hükümranlığını-hükümranlığın
ve-ve : krallığın-kral : cakasını-cakasın : en-en : pervasızca-pervasızc : en-en
şımarıkça-şımarıkç : yaşamış-yaşa : bir-bir : kral-kral : bile-bile : Katolik-Katolik
karısı-karı : Catherine-Catherin : ile-ile : sevgilisi-sevgi : Anne-Anne : Boleyn-Boley
arasında-ara : ki-ki : savaşta-savaş : sıkışıp-sıkış : yeni-yeni : bir-bir
din-din : icat-icat : etmek-et : ve-ve : bütün-bütün : memleketin-memleket
dinini-dinini : değiştirip-değiş : yıllarca-yıllarca : bitmeyecek-bit : kanlı-kan : bir-bir
din-din : savaşının-savaş : başlamasına-başla : neden-neden : olmak-ol : zorunda-zor
kalır-kal : Beşir-Beş : 19-19 : kişinin-kişi : öldüğü-öl : kilise-kilise
bombalamalarıyla-bombala : ilgili-ilgili : olarak-ol : da-da : zanlı-zanlı : ilan-ilan
edilmişti-ed : Önce-Önce : Hak-Hak : İş-İş : Genel-Genel : Başkanı-Başka
Necati-Necati : Çelik-Çelik : daha-daha : sonra-sonra : da-da : Türk-Türk
İş-İş : Genel-Genel : Başkanı-Başka : Bayram-Bayram : Meral'i-Meral : makamında-makam
kabul-kabul : eden-ed : Halis-Halis : grev-grev : ertelemesine-ertele : başvurulabilmesi-başvurulabilmes
için-için : genel-genel : sağlığı-sağ : ve-ve : kamu-kamu : güvenliğini-güven
ilgilendiren-ilgi : haklı-hak : bir-bir : nedenin-neden : olması-ol : gerektiğini-gerek
ifade-ifade : etti-et : II-II : GENÇ-GENÇ : Tut-Tut : onu-on
Dedim-De : ya-ya : taraftar-taraftar : yazarların-yazar : yazdıklarından-yazdıklarında : tribünlerin-tribün
"ruhsuz-"ruhsu : ibne"sine-ibne"sin : sıçramak-sıçra : hiç-hiç : zor-zor : değildir-değil
Fakat-Fakat : nedense-neden : babamın-baba : umurunda-umur : ymış-ym : Elazığ-Elazığ
yakınlarında-yakın : o-o : sıralarda-sıra : Vertetil-Vertetil : adı-adı : verilen-ver
yerde-yer : havaalanının-havaalan : yapımı-yap : tamamlandı-tamam : 68'de-68 : esen-esen
fırtınanın-fırtına : bütüncüllüğü-bütüncüllüğ : kitleselliği-kitlesel : hoşgörüsü-hoşgörü : kaybolmuştu-kaybol : Ben-Ben
de-de : öyle-öyle : sanıyordum-san : Sözde-Söz : devlet-devlet : ten-ten
yana-yana : olanlarını-olanların : sözde-söz : devlet-devlet : için-için : yapılanları-yapılanlar
meşrulaştırmaya-meşrulaştırmay : çalışıyoruz-çalış : Şu-Şu : önündeki-ön : kumun-kum : bir-bir
tanesi-tane : yim-yi : Doktora-Doktor : göre-göre : bir-bir : hafta-hafta
içinde-iç : geçebilirmiş-geçebilirm : bu-bu : felç-felç : Organize-Organiz : görüntümüz-görüntü
hoşlarına-hoş : gitmedi-git : Teröristler-Teröristle : iki-iki : kişiyi-kişi : kaçırdı-kaç
Ferrero-Ferrero : böylece-böylece : Estoril-Estoril : ve-ve : Barcelona'dan-Barcelona : sonra-sonra
toprak-toprak : korttaki-korttak : sezonun-sezon : üçüncü-üçüncü : birinciliğini-birinci : aldı-al
Çünkü-Çünkü : klinikte-klinikt : hekiminden-hekim : çözge-çözg : çare-çare : bekleyen-bekle
hastaların-hasta : dışında-dış : dır-dır : bu-bu : olanlar-ol : Ayrıca-Ayrıca
sevgilisi-sevgi : de-de : vardı-var : Ağabey-Ağabey : örtüleri-örtü : ütüleyip-ütüley
sana-san : getirdim-getir : dedi-de : Onun-On : odasının-oda : altındaki-alt
odada-oda : yatıyordum-yat : Bağlanmayan-Bağlanmaya : telefonlar-telefon : duyulmayan-duyulmaya : sesler-ses
geç-geç : giren-gir : görüntüler-görün : istemiyordum-iste : Böyle-Böyle : kandırmacalara-kandırmacalar
aldanmamalı-aldan : sinsi-sin : kışkırtmalara-kışkırt : direnmeliyim-diren : diyorum-di : kendi-kendi
kendime-kendi : Medyalamacılığın-Medyalamacılığı : efendisi-efendi : olarak-ol : baştan-baş : kabul-kabul
etmezsin-et : teklifini-teklif : ya-ya : da-da : iddia-iddia : ettiğin-et
kadar-kadar : ordinaryüssen-ordinaryüsse : o-o : röportajı-röportaj : da-da : idare-idare
etmeyi-et : becerirsin-becer : Beş-Beş : yıl-yıl : olmuştu-ol : Sadece-Sadece
iki-iki : gün-gün : kalacağımız-kal : için-için : bir-bir : iki-iki
giyecek-giyecek : ve-ve : hediye-hediye : paketleriyle-paket : yola-yol : koyulduk-koy
CHP-CHP : milletvekillerinin-milletvekil : duruşma-duruşma : salonunda-salon : izleyicilere-izleyiciler : ayrılmış-ayrı
olan-ol : sıralardan-sıra : takip-takip : etme-et : imkânına-imkân : rağmen-rağmen
özellikle-özellikle : sanık-san : müdafilerine-müdafilerin : ayrılmış-ayrı : sıralarda-sıra : oturduklarını-otur
dile-dile : getiren-getir : Savcı-Savcı : Pekgüzel-Pekgüzel : Şahin-Şahin : Mengü'yü-Mengü'y
de-de : kastederek-kastedere : istemini-iste : 